filename, language, C#, XML, JSON, aspnetcorerazor, PowerShell, comment, blank, total
c:\GOVMEETING\_SOURCECODE\BackEnd\Configuration_Lib\AppSettings.cs, C#, 21, 0, 0, 0, 0, 0, 2, 23
c:\GOVMEETING\_SOURCECODE\BackEnd\Configuration_Lib\Configuration_Lib.csproj, XML, 0, 5, 0, 0, 0, 0, 3, 8
c:\GOVMEETING\_SOURCECODE\BackEnd\Database\DatabaseAccess_Lib\ApplicationDbContext.cs, C#, 31, 0, 0, 0, 0, 6, 7, 44
c:\GOVMEETING\_SOURCECODE\BackEnd\Database\DatabaseAccess_Lib\ApplicationUser.cs, C#, 12, 0, 0, 0, 0, 1, 2, 15
c:\GOVMEETING\_SOURCECODE\BackEnd\Database\DatabaseAccess_Lib\DatabaseAccess_Lib.csproj, XML, 0, 14, 0, 0, 0, 0, 5, 19
c:\GOVMEETING\_SOURCECODE\BackEnd\Database\DatabaseAccess_Lib\dBOperations.cs, C#, 100, 0, 0, 0, 0, 107, 23, 230
c:\GOVMEETING\_SOURCECODE\BackEnd\Database\DatabaseAccess_Tests\DatabaseAccess_Tests.csproj, XML, 0, 14, 0, 0, 0, 0, 5, 19
c:\GOVMEETING\_SOURCECODE\BackEnd\Database\DatabaseAccess_Tests\DbCreateTests.cs, C#, 174, 0, 0, 0, 0, 34, 27, 235
c:\GOVMEETING\_SOURCECODE\BackEnd\Database\DatabaseModel_Lib\Category.cs, C#, 13, 0, 0, 0, 0, 6, 2, 21
c:\GOVMEETING\_SOURCECODE\BackEnd\Database\DatabaseModel_Lib\Citizen.cs, C#, 11, 0, 0, 0, 0, 3, 2, 16
c:\GOVMEETING\_SOURCECODE\BackEnd\Database\DatabaseModel_Lib\DatabaseModel_Lib.csproj, XML, 0, 5, 0, 0, 0, 0, 3, 8
c:\GOVMEETING\_SOURCECODE\BackEnd\Database\DatabaseModel_Lib\GovernmentBody.cs, C#, 20, 0, 0, 0, 0, 3, 2, 25
c:\GOVMEETING\_SOURCECODE\BackEnd\Database\DatabaseModel_Lib\Language.cs, C#, 13, 0, 0, 0, 0, 0, 2, 15
c:\GOVMEETING\_SOURCECODE\BackEnd\Database\DatabaseModel_Lib\Meeting.cs, C#, 25, 0, 0, 0, 0, 7, 4, 36
c:\GOVMEETING\_SOURCECODE\BackEnd\Database\DatabaseModel_Lib\Official.cs, C#, 13, 0, 0, 0, 0, 4, 2, 19
c:\GOVMEETING\_SOURCECODE\BackEnd\Database\DatabaseModel_Lib\Representative.cs, C#, 11, 0, 0, 0, 0, 1, 2, 14
c:\GOVMEETING\_SOURCECODE\BackEnd\Database\DatabaseModel_Lib\Speaker.cs, C#, 13, 0, 0, 0, 0, 3, 2, 18
c:\GOVMEETING\_SOURCECODE\BackEnd\Database\DatabaseModel_Lib\Talk.cs, C#, 17, 0, 0, 0, 0, 3, 2, 22
c:\GOVMEETING\_SOURCECODE\BackEnd\Database\DatabaseModel_Lib\Topic.cs, C#, 16, 0, 0, 0, 0, 3, 2, 21
c:\GOVMEETING\_SOURCECODE\BackEnd\Database\DatabaseModel_Lib\TopicDiscussion.cs, C#, 16, 0, 0, 0, 0, 0, 2, 18
c:\GOVMEETING\_SOURCECODE\BackEnd\Database\DatabaseRepositories_Lib\DatabaseRepositories_Lib.csproj, XML, 0, 9, 0, 0, 0, 0, 4, 13
c:\GOVMEETING\_SOURCECODE\BackEnd\Database\DatabaseRepositories_Lib\GovBodies\GovBodyRepository.cs, C#, 21, 0, 0, 0, 0, 0, 4, 25
c:\GOVMEETING\_SOURCECODE\BackEnd\Database\DatabaseRepositories_Lib\GovBodies\GovBodyRepository_Stub.cs, C#, 43, 0, 0, 0, 0, 0, 4, 47
c:\GOVMEETING\_SOURCECODE\BackEnd\Database\DatabaseRepositories_Lib\GovBodies\IGovBodyRepository.cs, C#, 12, 0, 0, 0, 0, 0, 2, 14
c:\GOVMEETING\_SOURCECODE\BackEnd\Database\DatabaseRepositories_Lib\Meetings\IMeetingRepository.cs, C#, 12, 0, 0, 0, 0, 0, 2, 14
c:\GOVMEETING\_SOURCECODE\BackEnd\Database\DatabaseRepositories_Lib\Meetings\MeetingRepository.cs, C#, 23, 0, 0, 0, 0, 1, 4, 28
c:\GOVMEETING\_SOURCECODE\BackEnd\Database\DatabaseRepositories_Lib\Meetings\MeetingRepository_Stub.cs, C#, 79, 0, 0, 0, 0, 0, 6, 85
c:\GOVMEETING\_SOURCECODE\BackEnd\Database\LoadDatabase_Lib\LoadDatabase_Lib.csproj, XML, 0, 12, 0, 0, 0, 0, 4, 16
c:\GOVMEETING\_SOURCECODE\BackEnd\Database\LoadDatabase_Lib\LoadTranscript.cs, C#, 54, 0, 0, 0, 0, 23, 12, 89
c:\GOVMEETING\_SOURCECODE\BackEnd\Database\LoadDatabase_Lib\ReadTranscriptFile.cs, C#, 21, 0, 0, 0, 0, 352, 37, 410
c:\GOVMEETING\_SOURCECODE\BackEnd\Database\LoadDatabase_Lib\ReadTranscriptFile_Stub.cs, C#, 41, 0, 0, 0, 0, 17, 5, 63
c:\GOVMEETING\_SOURCECODE\BackEnd\Online\GetOnlineFiles_Lib\GetOnlineFiles_Lib.csproj, XML, 0, 5, 0, 0, 0, 0, 3, 8
c:\GOVMEETING\_SOURCECODE\BackEnd\Online\GetOnlineFiles_Lib\GetVideo.cs, C#, 7, 0, 0, 0, 0, 4, 4, 15
c:\GOVMEETING\_SOURCECODE\BackEnd\Online\GoogleCloud_Lib\GoogleBucket.cs, C#, 49, 0, 0, 0, 0, 5, 8, 62
c:\GOVMEETING\_SOURCECODE\BackEnd\Online\GoogleCloud_Lib\GoogleCloudStorage.cs, C#, 65, 0, 0, 0, 0, 151, 64, 280
c:\GOVMEETING\_SOURCECODE\BackEnd\Online\GoogleCloud_Lib\GoogleCloud_Lib.csproj, XML, 0, 15, 0, 0, 0, 0, 5, 20
c:\GOVMEETING\_SOURCECODE\BackEnd\Online\GoogleCloud_Lib\StreamTranscribe.cs, C#, 68, 0, 0, 0, 0, 84, 6, 158
c:\GOVMEETING\_SOURCECODE\BackEnd\Online\GoogleCloud_Lib\TranscribeAudio.cs, C#, 144, 0, 0, 0, 0, 14, 32, 190
c:\GOVMEETING\_SOURCECODE\BackEnd\Online\GoogleCloud_Lib\TranscribeResponse.cs, C#, 39, 0, 0, 0, 0, 4, 7, 50
c:\GOVMEETING\_SOURCECODE\BackEnd\Online\OnlineAccess_Lib\FTPOperations.cs, C#, 108, 0, 0, 0, 0, 25, 22, 155
c:\GOVMEETING\_SOURCECODE\BackEnd\Online\OnlineAccess_Lib\OnlineAccess_Lib.csproj, XML, 0, 5, 0, 0, 0, 0, 3, 8
c:\GOVMEETING\_SOURCECODE\BackEnd\ProcessMeetings\FileDataRepositories_Lib\Addtags\AddtagsRepository.cs, C#, 47, 0, 0, 0, 0, 6, 14, 67
c:\GOVMEETING\_SOURCECODE\BackEnd\ProcessMeetings\FileDataRepositories_Lib\Addtags\IAddtagsRepository.cs, C#, 13, 0, 0, 0, 0, 7, 3, 23
c:\GOVMEETING\_SOURCECODE\BackEnd\ProcessMeetings\FileDataRepositories_Lib\CircularBuffer.cs, C#, 107, 0, 0, 0, 0, 30, 22, 159
c:\GOVMEETING\_SOURCECODE\BackEnd\ProcessMeetings\FileDataRepositories_Lib\FileDataRepositories_Lib.csproj, XML, 0, 24, 0, 0, 0, 0, 7, 31
c:\GOVMEETING\_SOURCECODE\BackEnd\ProcessMeetings\FileDataRepositories_Lib\Fixasr\FixasrRepository.cs, C#, 50, 0, 0, 0, 0, 6, 17, 73
c:\GOVMEETING\_SOURCECODE\BackEnd\ProcessMeetings\FileDataRepositories_Lib\Fixasr\IFixasrRepository.cs, C#, 13, 0, 0, 0, 0, 3, 4, 20
c:\GOVMEETING\_SOURCECODE\BackEnd\ProcessMeetings\FileDataRepositories_Lib\FormatConversions.cs, C#, 73, 0, 0, 0, 0, 38, 7, 118
c:\GOVMEETING\_SOURCECODE\BackEnd\ProcessMeetings\FileDataRepositories_Lib\GMFileAccess.cs, C#, 111, 0, 0, 0, 0, 18, 19, 148
c:\GOVMEETING\_SOURCECODE\BackEnd\ProcessMeetings\FileDataRepositories_Lib\MeetingFolder.cs, C#, 85, 0, 0, 0, 0, 26, 20, 131
c:\GOVMEETING\_SOURCECODE\BackEnd\ProcessMeetings\FileDataRepositories_Lib\UseTestData.cs, C#, 21, 0, 0, 0, 0, 4, 5, 30
c:\GOVMEETING\_SOURCECODE\BackEnd\ProcessMeetings\FileDataRepositories_Lib\ViewMeetings\IViewMeetingRepository.cs, C#, 12, 0, 0, 0, 0, 0, 3, 15
c:\GOVMEETING\_SOURCECODE\BackEnd\ProcessMeetings\FileDataRepositories_Lib\ViewMeetings\ViewMeetingRepository.cs, C#, 59, 0, 0, 0, 0, 8, 15, 82
c:\GOVMEETING\_SOURCECODE\BackEnd\ProcessMeetings\ProcessRecording_Lib\CreateJsonFiles.cs, C#, 94, 0, 0, 0, 0, 42, 21, 157
c:\GOVMEETING\_SOURCECODE\BackEnd\ProcessMeetings\ProcessRecording_Lib\ExtractAudio.cs, C#, 27, 0, 0, 0, 0, 14, 10, 51
c:\GOVMEETING\_SOURCECODE\BackEnd\ProcessMeetings\ProcessRecording_Lib\ModifyTranscriptJson.cs, C#, 47, 0, 0, 0, 0, 40, 8, 95
c:\GOVMEETING\_SOURCECODE\BackEnd\ProcessMeetings\ProcessRecording_Lib\Phrase.cs, C#, 12, 0, 0, 0, 0, 0, 1, 13
c:\GOVMEETING\_SOURCECODE\BackEnd\ProcessMeetings\ProcessRecording_Lib\ProcessRecording.cs, C#, 53, 0, 0, 0, 0, 18, 19, 90
c:\GOVMEETING\_SOURCECODE\BackEnd\ProcessMeetings\ProcessRecording_Lib\ProcessRecording_Lib.csproj, XML, 0, 14, 0, 0, 0, 0, 5, 19
c:\GOVMEETING\_SOURCECODE\BackEnd\ProcessMeetings\ProcessRecording_Lib\RunCommand.cs, C#, 25, 0, 0, 0, 0, 3, 8, 36
c:\GOVMEETING\_SOURCECODE\BackEnd\ProcessMeetings\ProcessRecording_Lib\SplitIntoWorkSegments.cs, C#, 25, 0, 0, 0, 0, 16, 8, 49
c:\GOVMEETING\_SOURCECODE\BackEnd\ProcessMeetings\ProcessRecording_Lib\SplitRecording.cs, C#, 72, 0, 0, 0, 0, 59, 20, 151
c:\GOVMEETING\_SOURCECODE\BackEnd\ProcessMeetings\ProcessRecording_Lib\SplitTranscript.cs, C#, 60, 0, 0, 0, 0, 21, 13, 94
c:\GOVMEETING\_SOURCECODE\BackEnd\ProcessMeetings\ProcessRecording_Tests\ProcessRecording_Tests.csproj, XML, 0, 11, 0, 0, 0, 0, 4, 15
c:\GOVMEETING\_SOURCECODE\BackEnd\ProcessMeetings\ProcessRecording_Tests\TestCloud.cs, C#, 67, 0, 0, 0, 0, 13, 24, 104
c:\GOVMEETING\_SOURCECODE\BackEnd\ProcessMeetings\ProcessRecording_Tests\TestProcessing.cs, C#, 62, 0, 0, 0, 0, 6, 19, 87
c:\GOVMEETING\_SOURCECODE\BackEnd\ProcessMeetings\ProcessTranscript_Lib\CommonFixes.cs, C#, 166, 0, 0, 0, 0, 23, 22, 211
c:\GOVMEETING\_SOURCECODE\BackEnd\ProcessMeetings\ProcessTranscript_Lib\ConvertPdfToText.cs, C#, 27, 0, 0, 0, 0, 11, 5, 43
c:\GOVMEETING\_SOURCECODE\BackEnd\ProcessMeetings\ProcessTranscript_Lib\ConvertToJson.cs, C#, 73, 0, 0, 0, 0, 5, 14, 92
c:\GOVMEETING\_SOURCECODE\BackEnd\ProcessMeetings\ProcessTranscript_Lib\ProcessTranscript_Lib.csproj, XML, 0, 15, 0, 0, 0, 1, 5, 21
c:\GOVMEETING\_SOURCECODE\BackEnd\ProcessMeetings\ProcessTranscript_Lib\ProcessTranscripts.cs, C#, 47, 0, 0, 0, 0, 22, 18, 87
c:\GOVMEETING\_SOURCECODE\BackEnd\ProcessMeetings\ProcessTranscript_Lib\SpecificFixesBase.cs, C#, 31, 0, 0, 0, 0, 4, 8, 43
c:\GOVMEETING\_SOURCECODE\BackEnd\ProcessMeetings\ProcessTranscript_Lib\Specific_Austin_TX_USA.cs, C#, 28, 0, 0, 0, 0, 0, 9, 37
c:\GOVMEETING\_SOURCECODE\BackEnd\ProcessMeetings\ProcessTranscript_Lib\Specific_Philadelphia_PA_USA.cs, C#, 78, 0, 0, 0, 0, 26, 40, 144
c:\GOVMEETING\_SOURCECODE\BackEnd\ProcessMeetings\ProcessTranscript_Lib\Talk.cs, C#, 16, 0, 0, 0, 0, 0, 2, 18
c:\GOVMEETING\_SOURCECODE\BackEnd\ProcessMeetings\ProcessTranscript_Lib\TranscriptFixes.cs, C#, 21, 0, 0, 0, 0, 6, 5, 32
c:\GOVMEETING\_SOURCECODE\BackEnd\ProcessMeetings\ViewModels_Lib\AddtagsView.cs, C#, 21, 0, 0, 0, 0, 5, 5, 31
c:\GOVMEETING\_SOURCECODE\BackEnd\ProcessMeetings\ViewModels_Lib\FixasrView.cs, C#, 25, 0, 0, 0, 0, 3, 9, 37
c:\GOVMEETING\_SOURCECODE\BackEnd\ProcessMeetings\ViewModels_Lib\MeetingView.cs, C#, 33, 0, 0, 0, 0, 5, 8, 46
c:\GOVMEETING\_SOURCECODE\BackEnd\ProcessMeetings\ViewModels_Lib\ViewModels_Lib.csproj, XML, 0, 5, 0, 0, 0, 0, 3, 8
c:\GOVMEETING\_SOURCECODE\BackEnd\WebApp\ConfigureAuthentication.cs, C#, 54, 0, 0, 0, 0, 15, 16, 85
c:\GOVMEETING\_SOURCECODE\BackEnd\WebApp\CurrentDirectoryHelpers.cs, C#, 56, 0, 0, 0, 0, 4, 9, 69
c:\GOVMEETING\_SOURCECODE\BackEnd\WebApp\Data\Migrations\00000000000000_CreateIdentitySchema.Designer.cs, C#, 152, 0, 0, 0, 0, 0, 67, 219
c:\GOVMEETING\_SOURCECODE\BackEnd\WebApp\Data\Migrations\00000000000000_CreateIdentitySchema.cs, C#, 197, 0, 0, 0, 0, 0, 23, 220
c:\GOVMEETING\_SOURCECODE\BackEnd\WebApp\Data\Migrations\ApplicationDbContextModelSnapshot.cs, C#, 151, 0, 0, 0, 0, 0, 67, 218
c:\GOVMEETING\_SOURCECODE\BackEnd\WebApp\Features\Account\AccountController.cs, C#, 438, 0, 0, 0, 0, 76, 52, 566
c:\GOVMEETING\_SOURCECODE\BackEnd\WebApp\Features\Account\ClaimInfo.cs, C#, 12, 0, 0, 0, 0, 0, 2, 14
c:\GOVMEETING\_SOURCECODE\BackEnd\WebApp\Features\Account\ConfirmEmail.cshtml, aspnetcorerazor, 0, 0, 0, 9, 0, 0, 2, 11
c:\GOVMEETING\_SOURCECODE\BackEnd\WebApp\Features\Account\ConfirmEmailError.cshtml, aspnetcorerazor, 0, 0, 0, 13, 0, 0, 2, 15
c:\GOVMEETING\_SOURCECODE\BackEnd\WebApp\Features\Account\ConfirmEmailPrompt.cshtml, aspnetcorerazor, 0, 0, 0, 25, 0, 0, 5, 30
c:\GOVMEETING\_SOURCECODE\BackEnd\WebApp\Features\Account\ConfirmEmailPromptViewModel.cs, C#, 16, 0, 0, 0, 0, 1, 3, 20
c:\GOVMEETING\_SOURCECODE\BackEnd\WebApp\Features\Account\ExternalLoginConfirmation.cshtml, aspnetcorerazor, 0, 0, 0, 31, 0, 0, 5, 36
c:\GOVMEETING\_SOURCECODE\BackEnd\WebApp\Features\Account\ExternalLoginConfirmationViewModel.cs, C#, 14, 0, 0, 0, 0, 0, 2, 16
c:\GOVMEETING\_SOURCECODE\BackEnd\WebApp\Features\Account\ExternalLoginFailure.cshtml, aspnetcorerazor, 0, 0, 0, 7, 0, 0, 2, 9
c:\GOVMEETING\_SOURCECODE\BackEnd\WebApp\Features\Account\ForgotPassword.cshtml, aspnetcorerazor, 0, 0, 0, 25, 0, 3, 4, 32
c:\GOVMEETING\_SOURCECODE\BackEnd\WebApp\Features\Account\ForgotPasswordConfirmation.cshtml, aspnetcorerazor, 0, 0, 0, 7, 0, 0, 2, 9
c:\GOVMEETING\_SOURCECODE\BackEnd\WebApp\Features\Account\ForgotPasswordViewModel.cs, C#, 14, 0, 0, 0, 0, 0, 2, 16
c:\GOVMEETING\_SOURCECODE\BackEnd\WebApp\Features\Account\Lockout.cshtml, aspnetcorerazor, 0, 0, 0, 7, 0, 0, 2, 9
c:\GOVMEETING\_SOURCECODE\BackEnd\WebApp\Features\Account\Login.cshtml, aspnetcorerazor, 0, 0, 0, 108, 0, 0, 10, 118
c:\GOVMEETING\_SOURCECODE\BackEnd\WebApp\Features\Account\LoginViewModel.cs, C#, 19, 0, 0, 0, 0, 0, 4, 23
c:\GOVMEETING\_SOURCECODE\BackEnd\WebApp\Features\Account\Over18Requirement.cs, C#, 8, 0, 0, 0, 0, 45, 3, 56
c:\GOVMEETING\_SOURCECODE\BackEnd\WebApp\Features\Account\Register.cshtml, aspnetcorerazor, 0, 0, 0, 58, 0, 0, 10, 68
c:\GOVMEETING\_SOURCECODE\BackEnd\WebApp\Features\Account\RegisterEmail.cshtml, aspnetcorerazor, 0, 0, 0, 16, 0, 0, 2, 18
c:\GOVMEETING\_SOURCECODE\BackEnd\WebApp\Features\Account\RegisterViewModel.cs, C#, 24, 0, 0, 0, 0, 0, 4, 28
c:\GOVMEETING\_SOURCECODE\BackEnd\WebApp\Features\Account\ResetPassword.cshtml, aspnetcorerazor, 0, 0, 0, 40, 0, 0, 4, 44
c:\GOVMEETING\_SOURCECODE\BackEnd\WebApp\Features\Account\ResetPasswordConfirmation.cshtml, aspnetcorerazor, 0, 0, 0, 7, 0, 0, 2, 9
c:\GOVMEETING\_SOURCECODE\BackEnd\WebApp\Features\Account\ResetPasswordViewModel.cs, C#, 23, 0, 0, 0, 0, 0, 5, 28
c:\GOVMEETING\_SOURCECODE\BackEnd\WebApp\Features\Account\SendCode.cshtml, aspnetcorerazor, 0, 0, 0, 18, 0, 0, 4, 22
c:\GOVMEETING\_SOURCECODE\BackEnd\WebApp\Features\Account\SendCodeViewModel.cs, C#, 15, 0, 0, 0, 0, 0, 5, 20
c:\GOVMEETING\_SOURCECODE\BackEnd\WebApp\Features\Account\UserInfo.cs, C#, 15, 0, 0, 0, 0, 0, 2, 17
c:\GOVMEETING\_SOURCECODE\BackEnd\WebApp\Features\Account\VerifyCode.cshtml, aspnetcorerazor, 0, 0, 0, 35, 0, 0, 4, 39
c:\GOVMEETING\_SOURCECODE\BackEnd\WebApp\Features\Account\VerifyCodeViewModel.cs, C#, 20, 0, 0, 0, 0, 0, 6, 26
c:\GOVMEETING\_SOURCECODE\BackEnd\WebApp\Features\Account\govmeetingClaim.cs, C#, 15, 0, 0, 0, 0, 0, 2, 17
c:\GOVMEETING\_SOURCECODE\BackEnd\WebApp\Features\Addtags\AddtagsController.cs, C#, 36, 0, 0, 0, 0, 3, 5, 44
c:\GOVMEETING\_SOURCECODE\BackEnd\WebApp\Features\Admin\AdminController.cs, C#, 162, 0, 0, 0, 0, 29, 31, 222
c:\GOVMEETING\_SOURCECODE\BackEnd\WebApp\Features\Admin\EditClaims.cshtml, aspnetcorerazor, 0, 0, 0, 4, 0, 0, 4, 8
c:\GOVMEETING\_SOURCECODE\BackEnd\WebApp\Features\Admin\EditUsers.cshtml, aspnetcorerazor, 0, 0, 0, 60, 0, 0, 17, 77
c:\GOVMEETING\_SOURCECODE\BackEnd\WebApp\Features\Admin\Index.cshtml, aspnetcorerazor, 0, 0, 0, 13, 0, 0, 5, 18
c:\GOVMEETING\_SOURCECODE\BackEnd\WebApp\Features\AspAuth\AspAuthController.cs, C#, 36, 0, 0, 0, 0, 0, 9, 45
c:\GOVMEETING\_SOURCECODE\BackEnd\WebApp\Features\AspAuth\Index.cshtml, aspnetcorerazor, 0, 0, 0, 7, 0, 0, 6, 13
c:\GOVMEETING\_SOURCECODE\BackEnd\WebApp\Features\AspAuth\Privacy.cshtml, aspnetcorerazor, 0, 0, 0, 5, 0, 0, 2, 7
c:\GOVMEETING\_SOURCECODE\BackEnd\WebApp\Features\Fixasr\FixasrController.cs, C#, 40, 0, 0, 0, 0, 3, 6, 49
c:\GOVMEETING\_SOURCECODE\BackEnd\WebApp\Features\GovBodies\GovBodyController.cs, C#, 27, 0, 0, 0, 0, 24, 10, 61
c:\GOVMEETING\_SOURCECODE\BackEnd\WebApp\Features\Home\HomeController.cs, C#, 33, 0, 0, 0, 0, 3, 8, 44
c:\GOVMEETING\_SOURCECODE\BackEnd\WebApp\Features\Manage\AddPhoneNumber.cshtml, aspnetcorerazor, 0, 0, 0, 27, 0, 0, 4, 31
c:\GOVMEETING\_SOURCECODE\BackEnd\WebApp\Features\Manage\AddPhoneNumberViewModel.cs, C#, 15, 0, 0, 0, 0, 0, 2, 17
c:\GOVMEETING\_SOURCECODE\BackEnd\WebApp\Features\Manage\ChangePassword.cshtml, aspnetcorerazor, 0, 0, 0, 40, 0, 0, 5, 45
c:\GOVMEETING\_SOURCECODE\BackEnd\WebApp\Features\Manage\ChangePasswordViewModel.cs, C#, 24, 0, 0, 0, 0, 0, 4, 28
c:\GOVMEETING\_SOURCECODE\BackEnd\WebApp\Features\Manage\ConfigureTwoFactorViewModel.cs, C#, 13, 0, 0, 0, 0, 0, 3, 16
c:\GOVMEETING\_SOURCECODE\BackEnd\WebApp\Features\Manage\FactorViewModel.cs, C#, 11, 0, 0, 0, 0, 0, 2, 13
c:\GOVMEETING\_SOURCECODE\BackEnd\WebApp\Features\Manage\Index.cshtml, aspnetcorerazor, 0, 0, 0, 65, 0, 0, 7, 72
c:\GOVMEETING\_SOURCECODE\BackEnd\WebApp\Features\Manage\IndexViewModel.cs, C#, 16, 0, 0, 0, 0, 0, 6, 22
c:\GOVMEETING\_SOURCECODE\BackEnd\WebApp\Features\Manage\ManageController.cs, C#, 300, 0, 0, 0, 0, 39, 30, 369
c:\GOVMEETING\_SOURCECODE\BackEnd\WebApp\Features\Manage\ManageLogins.cshtml, aspnetcorerazor, 0, 0, 0, 54, 0, 0, 4, 58
c:\GOVMEETING\_SOURCECODE\BackEnd\WebApp\Features\Manage\ManageLoginsViewModel.cs, C#, 14, 0, 0, 0, 0, 4, 3, 21
c:\GOVMEETING\_SOURCECODE\BackEnd\WebApp\Features\Manage\RemoveLoginViewModel.cs, C#, 13, 0, 0, 0, 0, 0, 2, 15
c:\GOVMEETING\_SOURCECODE\BackEnd\WebApp\Features\Manage\SetPassword.cshtml, aspnetcorerazor, 0, 0, 0, 36, 0, 0, 5, 41
c:\GOVMEETING\_SOURCECODE\BackEnd\WebApp\Features\Manage\SetPasswordViewModel.cs, C#, 20, 0, 0, 0, 0, 0, 3, 23
c:\GOVMEETING\_SOURCECODE\BackEnd\WebApp\Features\Manage\VerifyPhoneNumber.cshtml, aspnetcorerazor, 0, 0, 0, 28, 0, 0, 5, 33
c:\GOVMEETING\_SOURCECODE\BackEnd\WebApp\Features\Manage\VerifyPhoneNumberViewModel.cs, C#, 17, 0, 0, 0, 0, 0, 3, 20
c:\GOVMEETING\_SOURCECODE\BackEnd\WebApp\Features\Meetings\MeetingController.cs, C#, 27, 0, 0, 0, 0, 24, 10, 61
c:\GOVMEETING\_SOURCECODE\BackEnd\WebApp\Features\Shared\Error.cshtml, aspnetcorerazor, 0, 0, 0, 5, 0, 0, 2, 7
c:\GOVMEETING\_SOURCECODE\BackEnd\WebApp\Features\Shared\TypedOptions.cs, C#, 14, 0, 0, 0, 0, 0, 1, 15
c:\GOVMEETING\_SOURCECODE\BackEnd\WebApp\Features\Shared\_DevNotePartial.cshtml, aspnetcorerazor, 0, 0, 0, 12, 0, 3, 2, 17
c:\GOVMEETING\_SOURCECODE\BackEnd\WebApp\Features\Shared\_Layout.cshtml, aspnetcorerazor, 0, 0, 0, 63, 0, 4, 12, 79
c:\GOVMEETING\_SOURCECODE\BackEnd\WebApp\Features\Shared\_LoginPartial.cshtml, aspnetcorerazor, 0, 0, 0, 20, 0, 7, 7, 34
c:\GOVMEETING\_SOURCECODE\BackEnd\WebApp\Features\Shared\_ValidationScriptsPartial.cshtml, aspnetcorerazor, 0, 0, 0, 14, 0, 0, 1, 15
c:\GOVMEETING\_SOURCECODE\BackEnd\WebApp\Features\TestApi\TestapiController.cs, C#, 14, 0, 0, 0, 0, 0, 3, 17
c:\GOVMEETING\_SOURCECODE\BackEnd\WebApp\Features\Video\VideoController.cs, C#, 21, 0, 0, 0, 0, 9, 3, 33
c:\GOVMEETING\_SOURCECODE\BackEnd\WebApp\Features\ViewMeetings\ViewMeetingController.cs, C#, 27, 0, 0, 0, 0, 1, 5, 33
c:\GOVMEETING\_SOURCECODE\BackEnd\WebApp\Features\_ViewImports.cshtml, aspnetcorerazor, 0, 0, 0, 6, 0, 14, 5, 25
c:\GOVMEETING\_SOURCECODE\BackEnd\WebApp\Features\_ViewStart.cshtml, aspnetcorerazor, 0, 0, 0, 3, 0, 19, 2, 24
c:\GOVMEETING\_SOURCECODE\BackEnd\WebApp\Program.cs, C#, 52, 0, 0, 0, 0, 11, 6, 69
c:\GOVMEETING\_SOURCECODE\BackEnd\WebApp\Properties\launchSettings.json, JSON, 0, 0, 27, 0, 0, 0, 0, 27
c:\GOVMEETING\_SOURCECODE\BackEnd\WebApp\PsScripts\Build-ClientApp.ps1, PowerShell, 0, 0, 0, 0, 40, 16, 25, 81
c:\GOVMEETING\_SOURCECODE\BackEnd\WebApp\PsScripts\Copy-ClientAssets.ps1, PowerShell, 0, 0, 0, 0, 98, 36, 44, 178
c:\GOVMEETING\_SOURCECODE\BackEnd\WebApp\PsScripts\Publish-WebApp.ps1, PowerShell, 0, 0, 0, 0, 3, 0, 0, 3
c:\GOVMEETING\_SOURCECODE\BackEnd\WebApp\PsScripts\Run-ClientApp.ps1, PowerShell, 0, 0, 0, 0, 2, 0, 0, 2
c:\GOVMEETING\_SOURCECODE\BackEnd\WebApp\PsScripts\Run-PublishedWebApp.ps1, PowerShell, 0, 0, 0, 0, 3, 0, 0, 3
c:\GOVMEETING\_SOURCECODE\BackEnd\WebApp\Services\DbInitializer.cs, C#, 54, 0, 0, 0, 0, 40, 12, 106
c:\GOVMEETING\_SOURCECODE\BackEnd\WebApp\Services\EmailService.cs, C#, 179, 0, 0, 0, 0, 37, 26, 242
c:\GOVMEETING\_SOURCECODE\BackEnd\WebApp\Services\IEmailSender.cs, C#, 11, 0, 0, 0, 0, 0, 2, 13
c:\GOVMEETING\_SOURCECODE\BackEnd\WebApp\Services\ISmsSender.cs, C#, 11, 0, 0, 0, 0, 0, 2, 13
c:\GOVMEETING\_SOURCECODE\BackEnd\WebApp\Services\MessageServices.cs, C#, 93, 0, 0, 0, 0, 44, 13, 150
c:\GOVMEETING\_SOURCECODE\BackEnd\WebApp\Services\RedirectConsole.cs, C#, 44, 0, 0, 0, 0, 0, 6, 50
c:\GOVMEETING\_SOURCECODE\BackEnd\WebApp\Services\StatusRequirement.cs, C#, 8, 0, 0, 0, 0, 27, 6, 41
c:\GOVMEETING\_SOURCECODE\BackEnd\WebApp\Services\ValidateReCaptchaAttribute.cs, C#, 82, 0, 0, 0, 0, 1, 1, 84
c:\GOVMEETING\_SOURCECODE\BackEnd\WebApp\Startup.cs, C#, 159, 0, 0, 0, 0, 61, 46, 266
c:\GOVMEETING\_SOURCECODE\BackEnd\WebApp\StartupCustomizations\FeatureLocationExpander.cs, C#, 18, 0, 0, 0, 0, 3, 3, 24
c:\GOVMEETING\_SOURCECODE\BackEnd\WebApp\WebApp.csproj, XML, 0, 75, 0, 0, 0, 6, 18, 99
c:\GOVMEETING\_SOURCECODE\BackEnd\WebApp\appsettings.Development.json, JSON, 0, 0, 9, 0, 0, 0, 1, 10
c:\GOVMEETING\_SOURCECODE\BackEnd\WebApp\appsettings.json, JSON, 0, 0, 44, 0, 0, 0, 1, 45
c:\GOVMEETING\_SOURCECODE\BackEnd\WebApp\commands.json, JSON, 0, 0, 29, 0, 0, 0, 0, 29
c:\GOVMEETING\_SOURCECODE\BackEnd\WorkflowApp\DirectoryWatcher.cs, C#, 58, 0, 0, 0, 0, 21, 15, 94
c:\GOVMEETING\_SOURCECODE\BackEnd\WorkflowApp\ProcessFixedAsr.cs, C#, 33, 0, 0, 0, 0, 5, 9, 47
c:\GOVMEETING\_SOURCECODE\BackEnd\WorkflowApp\ProcessIncomingFiles.cs, C#, 86, 0, 0, 0, 0, 25, 19, 130
c:\GOVMEETING\_SOURCECODE\BackEnd\WorkflowApp\ProcessTagged.cs, C#, 12, 0, 0, 0, 0, 1, 4, 17
c:\GOVMEETING\_SOURCECODE\BackEnd\WorkflowApp\Program.cs, C#, 61, 0, 0, 0, 0, 27, 13, 101
c:\GOVMEETING\_SOURCECODE\BackEnd\WorkflowApp\RetrieveOnlineFiles.cs, C#, 52, 0, 0, 0, 0, 21, 13, 86
c:\GOVMEETING\_SOURCECODE\BackEnd\WorkflowApp\Workflow.cs, C#, 47, 0, 0, 0, 0, 21, 13, 81
c:\GOVMEETING\_SOURCECODE\BackEnd\WorkflowApp\WorkflowApp.csproj, XML, 0, 34, 0, 0, 0, 0, 7, 41
c:\GOVMEETING\_SOURCECODE\BackEnd\WorkflowApp\appsettings.json, JSON, 0, 0, 26, 0, 0, 0, 1, 27
c:\GOVMEETING\_SOURCECODE\BackEnd\XTestDI\ProcessFixedAsr.cs, C#, 33, 0, 0, 0, 0, 5, 10, 48
c:\GOVMEETING\_SOURCECODE\BackEnd\XTestDI\Program.cs, C#, 48, 0, 0, 0, 0, 32, 18, 98
c:\GOVMEETING\_SOURCECODE\BackEnd\XTestDI\XTestDI.csproj, XML, 0, 24, 0, 0, 0, 0, 6, 30
c:\GOVMEETING\_SOURCECODE\BackEnd\XTestDI\appsettings.json, JSON, 0, 0, 26, 0, 0, 0, 1, 27
Total, -, 6257, 286, 161, 868, 146, 2120, 1707, 11545